WE       img/w.xpm


NO img/n.xpm

SO img/s.xpm                  

EA img/e.xpm

F 42,42,42

C 240,240,0





1111111
11000001
100100001
100000001
100000001
100000011
110000011
110000011
110000011
110000011
110000011
110000011
110000011
110000011
110000011
110000011
110000011
110000011
110000011
110000011
111111111



11
1S1
11



