WE       img/wall_greyF.xpm


NO img/wall_redF.xpm

SO img/wall_brownF.xpm

EA img/wall_orangeF.xpm

F 42,0,42

C 240,240,0

11111111
11000001
1001110011
100000001
10000001
100000011
110000011
110000011
110000011
11000011
110000011
110000011
110000011
110000011
11000W011
110000011
11000011
11000011
11000011
110000011
111111111


111
111
1111