WE       img/w.xpm


NO img/n.xpm

SO img/s.xpm                  

EA img/e.xpm

F 42,42,42

C 240,240,0

11111111
11000001
1001111011
100000001
10000001
100000011
110000011
110000011
110000011
11W000011
110000011
110000011
111000011
110000011
110000011
110000011
11000011
11000011
11000011
110000011
111111111


111
111
1111