WE       img/wall_greyF.xpm


NO img/wall_redF.xpm

SO img/wall_brownF.xpm

EA img/wall_orangeF.xpm

F 42,42,42
C 240,240,0

11111
10001
10E01
10001
11111
