WE img/w.xpm
NO img/n.xpm
SO img/s.xpm
EA img/e.xpm

F 42,42,42
C 240,240,0

11111
10001
10E01
10001
11111
