WE       img/wall_greyF.xpm



F 0,10,100

SO img/wall_brownF.xpm

EA img/wall_orangeF.xpm
















NO                                     img/wall_redF.xpm

C 175              , 255 ,        238


111111
100101
101001
1100N1
111111