WE       img/wall_greyF.xpm


NO img/wall_redF.xpm

SO img/wall_brownF.xpm

EA img/wall_orangeF.xpm

F 244,164,96
C 175,238,238










         111111111111111111111111
        1000000000110000000000001
        1011000001110000000000001
        1001000000000000000000001
111111111011000001110000000000001
100000000011000001110111110111111
11110111111111011100000010001
11110111111111011101010000001
11000000110101011100000001101
100000000000S0000000000010001
10000000000000001101010010001
110000011101010111110111100011
11110111 1110101 101111010001
11111111 1110111 111111111111
           101
           101
           101
           101
           101
           101
           101
           101
           101
           111
