WE       img/w.xpm


NO img/n.xpm

SO img/s.xpm                  

EA img/e.xpm

F 42,42,42

C 240,240,0
111111111111111111111111111
10000001000000010000010E111
100000010001100101000100111
100000010001100101000000111
100000000001100001111111111
111111111111111001111111111
100001000000010000000111111
111100000000000000000001111
111111111111111111111111111
