WE       img/wall_greyF.xpm


NO img/wall_redF.xpm

SO img/wall_brownF.xpm

EA img/wall_orangeF.xpm

F 244,164,96


C 175,238,238
111111111111111111111111111
100000010000000100000100111
100000010001100101000100111
100000010001100101000000111
100000000001100001111111111
111111111111111001111111111
100001000000010000000111111
1111000000000000N0000001111
111111111111111111111111111
1111111111111111111111111111111111111111
11111111111111111111111111111111111111111
11111111111111111111111111111111111111111
111111111111111111111111111111111111111111111
1111111111111111000000000000000000000000000001
1111111111111111111111111111111111111111111111
1
