WE       img/w.xpm


NO img/n.xpm

SO img/s.xpm

EA img/e.xpm

F 42,42,42

C 240,240,0

1111111111111111111111111
    1S1
     1
