WE       img/wall_greyF.xpm


NO img/wall_redF.xpm

SO img/wall_brownF.xpm

EA img/wall_orangeF.xpm

F 42,42,42

C 240,240,0

1111111111111111111111111
    1S1
     1
