WE       img/wall_greyF.xpm


NO img/wall_redF.xpm

SO img/wall_brownF.xpm

EA img/wall_orangeF.xpm
F 244,164,96
C 175,238,238

1111111111111111111111111
    1S1
     1
